dd	昌|昍
dm	明
da	止
dt	閑|杲|喿
dw	曼
df	景|炅|炚
dy	量
dz	昇|昜
dl	閏
dj	早
dx	旲|旻
di	即
de	旦
dk	門
db	是
dh	昆
ds	時
do	閣
dc	既
dr	暴
du	巴|旵
dg	衰|艮
dq	冒|闌
dn	||ㄚ|ㄙ|ㄝ|ㄟ
dp	晃
dv	星
d;	最
d,	||曷
mm	朋
ma	肌|冗|貝
mt	采
mw	愛|爰
mf	炙
my	肚
mz	爭
ml	爵
mj	軍
mx	愛|奚
mi	央
me	且|肛|囗
mk	肊
mb	肉|冢
mh	悉
ms	用
mo	向
mc	助
mr	冊|皿|血
mu	目
mg	妥|罔
mq	番
mn	岡|ㄅ|舀
mp	丹|孚
mv	冥|冞
m;	同
m,	周
ad	曾|鈤
am	帶|鈅
aa	交
at	朵|桀
aw	發
af	然|鈥
ay	堅|釷
az	弟|鉌
al	公|凡
aj	針
ax	父|釱|契
ai	丫|卯|卬
ae	登|釭
ak	劉|釔|鉺
ab	聚|象
ah	怨|鈊
ao	釦
ac	分|鉐
ar	鉗
au	釓|兌
ag	釹|褱
aq	留|鈿|鉬
an	ㄒ|ㄘ|絜
ap	釙|釨
av	粲|銤
a;	風
a,	翁
td	杳
tm	相|朿
ta	賴|机|朳
tt	林
tw	皮
tf	杰|柬
ty	杜
tz	才
tl	寸|松
tj	末
tx	敕|樊|夬|杕
ti	束|析
te	本|杠
tk	剌|栮
tb	來
th	朼|杺
ts	杽|韋
to	杏|可
tc	柘
tr	柑
tu	札
tg	囊
tq	東|相
tn	查|ㄉ|˙|棩
tp	朴|李|杍
tv	欶
t;	屬
t,	禁
wd	汨|汩|沓
wm	脊
wa	淦|汃
wt	沐
ww	雙|沝
wf	加
wy	圣
wz	沙
wl	叉|梁
wj	汁
wx	汏
wi	沖|充
we	江
wk	洱
wh	沁
ws	溥|夆
wo	各|呇
wc	沰
wr	泔
wu	汕|兆
wg	汝
wq	沺
wn	淵|||ㄝ|ㄟ|ㄧ
wp	冬
wv	漁
w;	蚤
w,	洋||
fm	肖
fa	賞
ft	米|炑
ff	炎
fy	灶
fz	少
fl	瓜
fx	尖
fi	爪
fe	丕|灴
fk	鄰
fb	尐
fh	忝
fs	半
fo	否|尚
fc	勞
fr	蓋
fu	光
fq	當
fn	危|ㄈ|ˋ
fv	省
f;	黨
f,	烊|喬
yd	者
ym	冉
ya	赤
yt	封
yw	鼓
yf	焦
yy	圭
yz	彭
yl	去
yx	敖
ye	壹
yk	邗
yb	走
yh	志|老
ys	寺|尌
yo	吉
yc	考
yr	坩|盍
yu	堯|圠
yg	袁
yq	賣
yn	幸|ㄍ|ㄐ|ㄛ
yp	孝
yv	嗇
y;	壽
y,	平|垟
zd	白|香
zm	策|禹
za	質
zt	乎|禾
zw	反
zf	秋
zy	重|壬
zz	身|秝
zl	鬼|么|私
zj	千|秀
zx	夭
zi	秉|种
ze	垂|笁
zk	行|几|利
zb	八|彳|徙
zh	乘|乇
zs	牛
zo	和
zc	戶|乍
zr	升
zu	禿|秈
zg	委|氏
zq	自
zn	系|臼|ㄏ
zp	季
zv	乏
z;	舌
z,	鼻
ld	靡
lm	甫|禸|玥
la	麻|朮
lt	床
lw	求
lf	為
ly	庄|至
lz	戊|尨
ll	戔|玉|玊|戍
lj	戎
lx	犬
li	州
le	戌|玒
lk	郎|珥
lb	庂|次
lh	弋|庀
ls	玤|尃
lo	台
lc	成
lr	戒|弁|弄|玵
lu	尤|允
lg	戉
lq	廣
ln	廉|||˙|ㄞ
lp	戚
lv	牟
l;	咸
l,	||庠|珜
jd	宣
jm	朝|巿
ja	穴|宛
jt	未|宋
jw	支
jf	宗
jy	幹
jz	宅
jl	戟
jj	車|廾|卄
jx	丈|軑
ji	官
je	士|直
jk	寧
jb	定
jh	它
js	害
jo	古
jc	宕
jr	卉
ju	七|軋
jg	安
jq	寅
jn	南|ㄨ
jp	字
jv	宁
j;	賁
j,	宴
xd	音
xm	有|冇
xt	奇
xw	友
xf	灰|疢|寮
xy	在|童
xz	參
xl	太
xj	辛
xx	疾|爻|犮
xi	章
xe	左|疘
xk	九|夷|耷
xb	夾
xh	意|疕
xs	達
xo	右
xc	力
xr	疳
xu	尢|疝|竟
xg	妾
xq	親
xn	夸|ㄎ|ㄜ
xp	存
xv	龍
x;	布|痋
x,	商|痒|羍
id	書|衵
im	巾|期|帚
ia	其
it	余
iw	度
if	庶|熏
iy	基
il	尋
ij	卑
ix	史|敦
ii	串|衶
ie	畫|韭
ik	鬥
ib	欺
ih	忠|惎
is	聿
io	君
ic	甚|碁
ir	盡
iu	儿|冘
ig	婁
iq	由
in	肅|ㄌ|綦|裫
ip	非
iv	申
i;	貴
i,	曳
ed	百
em	需
ea	頁
et	于
ew	汞|憂
ef	不|示
ey	王|霍
ez	歷|厂
el	云
ej	干|計
ex	天|更
ei	而|丌
ee	二|酉|訌
ek	丁|邛
eb	仄|巫|豕
eh	息
es	死|厄
eo	石|吾
ec	列|万
er	幵|亞|詌
eu	元|兀|兀|訕
eg	瓦|辰|匚
eq	面
en	諸|西|ㄣ|ˊ|ㄇ|ㄢ|雩
ep	下|訃
ev	麗
e;	豆
e,	詳|丙
kd	色
km	角
ka	小
kt	子
kw	取|氶
kf	耿|烝
ky	丑
kz	矛
kl	夕|弘
kj	乃
kx	又|敢
ki	引|弔
ke	隆
kk	了|耶|弭|聑
kb	久|欠
kh	恥
ks	解|丮
ko	名
kc	弱
kr	多
ku	乙|免|耴
kg	弦
kq	費
kn	|卍|ㄋ|ㄥ
kp	外|丸
kv	氣
k;	強|虱
k,	
bd	會
bm	內|仴
ba	仈|仉
bt	休
bw	任|汆|复
bf	伙|尒|無
by	仕|隹
bz	入
bl	伐
bj	什|午
bx	矢|侯
bi	仲
be	丘|仜|仝|韱
bk	乞|佴
bb	從|僉
bh	化|伈
bs	年
bo	合
bc	乍
br	侖|龠|弇
bu	仙|仚|屳
bg	食|胥
bq	佃|每
bn	ㄛ|ˋ|ㄔ|ㄡ|||今
bp	仆|仔|俞
bv	令
b;	倉
b,	||禽|佯
hd	旨|旬
hm	甬
ha	真|惍
ht	也
hw	永
hf	鹿|麃
hy	離|坒
hz	必
hl	勾|勺
hj	勿
hx	獻|忕
hi	忡
he	式
hk	予|乜
hb	疑
hh	比
hs	射
ho	句
hc	虜
hr	世
hu	屯|虎
hg	嬰
hq	甸
hn	ㄆ|芻|匋
hp	武|勻
hv	匊
h;	皆
h,	顛
sd	春|抇
sm	青|抈
sa	責|扒
st	耒
sw	泰|段
sf	抄
sz	秦
sl	找
sj	丰|翠
sx	奏
si	折
se	扛
sk	邦|挕
sb	夫
sh	慧
ss	奉
so	扣
sc	拓|砉
sr	拑
su	扎|毛
sg	表
sq	毒|鹵
sn	素|ㄗ|舂
sp	扑|斿
s;	習
s,	？
om	肙
oa	只|叭|員
ot	呆
of	烏|吙
oy	吐
oz	路|呏
ol	呈
oj	單
ox	吳
oi	嚴|叩
oe	屈
ok	咠|咡
ob	足
oh	叱
os	兄
oo	呂
oc	另|叻
or	咁
ou	巳|包
og	民|吆
oq	居
on	ㄜ|ㄖ|ㄦ|ˊ|咢
op	號|吇
ov	咪
o;	黽
o,	咩
cd	區
cm	肩
ca	匹|巽
ct	牙
cw	尿|泵|砅
cf	馬
cy	翟
cz	刀
cl	尉
cj	耳|辟
cx	尹
ci	臣
ce	刁|詹|矼
ck	那
cb	尺|厥
ch	尼
cs	犀
co	叵|召
cc	巨|羽|砳
cr	扁
cu	己|已
cg	長|展
cq	眉|屇
cn	屋|ㄙ|ㄕ|ㄣ
cp	矷
cv	屎
c;	司|扈
c,	匽
rd	昔
rm	萬
ra	共|菳
rt	某|葉
rw	藝
rf	燕|苂
ry	董|芏|雚
rz	蔑
rl	義|茂
rj	華|卅|革
rx	英|艾
ri	草
re	甘
rk	芎|茸
rb	蒙
rh	芯|葛
rs	羊|堇|羋
ro	若|善|荅
rc	刑
rr	井|并|卌
ru	巷
rg	農
rq	曲|苗|酋|苜
rn	莫|ㄊ|ㄤ
rp	芓
rv	芝
r;	鄭|茧|菂|冓
r,	黃
ud	晉
um	庸
ua	崟
ut	臬
uw	康
uy	崔
uz	匕|密
ul	兔
uj	巂
ux	凶
ui	屮|耑
ue	空
uk	前
ub	庚|疌
uh	惠
us	專
uo	唐
uc	岩
ur	豈
uu	出|屾|艸
ug	妻
uq	雷
un	ㄨ|ㄩ|||岑
uv	崩
u;	豐
u,	|
gd	昏
gm	師
ga	賓
gt	樂
gw	奴|彔
gf	糸
gy	壯
gz	姀
gl	幾|戕
gj	連
gx	便|矣
gi	斷|凵
ge	氐|妅
gk	鄉
gb	以|彖
gh	感
gs	將|妦
go	如
gc	幻|幼
gr	姏
gu	奾
gg	妝|奻
gq	牆|甾
gn	ㄑ|ˇ
gp	好
gv	寶
g;	巢|姑
g,	牂
qd	曹
qm	胃
qa	四|貫
qt	果|困
qf	黑
qy	里
qz	縣|囷
ql	禺
qj	畢|毋|毌
qx	因
qi	甲
qe	國
qk	則|眲
qb	囚
qh	思
qs	尊
qo	回
qc	男
qr	鼎
qu	見
qg	畏|囡
qq	圖
qn	累|ㄓ|ㄠ
qp	母|囝
qv	眯
q;	豊
q,	困|眻
nd	肴|曶
nm	朔
na	兼
nt	”
nw	毀
nf	京|廌
ny	坐
nz	「
nl	約
nj	」
nx	奐
ni	希
ne	紅|巠
nk	亨
nb	豪|臾
nh	忽
no	谷
nc	“
nr	紺|舁
nu	兒
ng	鼠|襄
nq	細
nn	絲|臿
np	享
nv	覺
n;	含
n,	局
pd	逢
pm	高
pa	六|亦|亢
pt	施
pw	般|叔
pf	孫|焉
py	主
pz	步|歲
pl	廷
pj	斗
px	文
pi	卓|舯
pe	上|舡
pk	夜|郭|邡
pb	逐|亥
ph	此|虍
ps	建
po	占
pc	邊|方|迉
pr	立|遂
pu	齒|孔|舢|辿
pg	亡|衣|玄
pq	畜|貞
pn	齊|逆|ㄩ|ㄚ
pp	於|卞|孖
pv	迷
p;	延
p,	過
vd	魯
vm	爾
va	買
vt	朱|栗
vw	眾
vf	票
vy	羅|壟|垔
vz	穌
vl	、
vj	籵|睪
vx	奧
vi	覃
ve	生|魟
vk	聾
vb	失
vh	念|愻
vo	告
vc	制|礱
vr	益|魽
vu	先
vg	要|籹
vq	贊
vn	甹
vp	罪|籽
vv	粟|卍
v;	蜀|蠪
v,	鮮
;d	朁|蚎
;m	胡|鬲
;a	資|虮
;t	柔|蚞
;w	泉
;f	原
;y	臺
;z	鬱
;l	皇
;j	率|皋
;i	帝
;e	言|虹
;k	及
;b	楚
;s	蚌
;o	喜
;c	務
;r	監|蚶
;u	覽
;g	良
;q	首
;n	蜵|矞
;p	旁
;v	卒
;;	；|帛
;,	蛘
,d	耆
,m	骨
,a	舜
,t	栽
,w	受|愛
,f	狄|羔
,y	窒
,l	狂
,j	載
,x	美
,i	狆
,e	差
,k	弮
,h	恙
,s	拳
,o	容|哉|咼
,c	券|羲
,r	對
,u	亂|羌
,g	養|姜
,q	眷
,n	卷|絭
,v	鯗
,;	蛓
,,	，|离
